11111111111111111111111
10000000000000000000001
10101001111011110111101
100E0000001000010100101
10001000001000010100101
10001001111011110000101
10001000001000010000101
10001000001000010000101
10011101111011110000101
1PC00000000000000000001
11111111111111111111111