11111111111111111111111
10000000000000000000001
10111001111011110111101
10011000001000010100101
1000100CC01CCCC101CC101
1CC01CC111101111CCCC101
1CC0100000100C010000101
10001000001000010000101
10011101111011110000101
1PCE0000000000000000001
11111111111111111111111