11111111111111111111111
1D0000000CEP00000000001
11111111111111111111111