11111111111111111111111
1C00000C00000000E000001
1000C000DC0000C000C00P1
11111111111111111111111