111111111
100000001
1CE00PC01
111111111