11111111111111111111111111
10000000000000000000001CE1
10000C0000000000000000CC11
10000000000000000000000001
10000000000000000000000001
10000000000000000000000001
10000000000000000000000001
10000000000000000000000001
10000000000000000000000001
1P000000000000000000000001
11111111111111111111111111