11111111111111111111111111
10000000000000100000001CE1
10000C0000000010000000CC11
10000000000000100000000001
10000000000000100000000001
10000000000000100000000001
10000000000000100000000001
10000000000000100000000001
10000000000000100000000001
1P000000000000000000000011
11111111111111111111111111