111111111
100D00001
1CE00PC01
111111111