1111111111111
111E1110000P1
100C000D00001
1111111111111