1111111111111
1C0E111111111
10D00000000P1
1111111111111