11111111111111
1000000EPC0001
10000000000011
11111111111001