11111111111
11111111111
10000000001
11111111111
1111111111
11111111111
11111111111