11111111111111
10D0000EPC0001
11111111111111