1111111111111111111111
1000000000000000000001
1000000000000000000001
10000000000001E1000001
1000000000000010000001
1000000000000000000001
1000000C00000000000001
10000000P0000000000001
1111111111111111111111