11111111111
1C11E111111
1P0111C0001
11111111111